#####
#@  #
#  $#
# $ # ###
### ###.#
 ##    .#
 #   #  #
 #   ####
 #####
