#########
#       #
# @ $ . #
#       #
#########